"filename", "language", "C++", "YAML", "XML", "CMake", "Markdown", "comment", "blank", "total"
"/home/sunny/workspace_private/3rd-test-learning/1. glog/src/glog-test.cpp", "C++", 15, 0, 0, 0, 0, 11, 10, 36
"/home/sunny/workspace_private/3rd-test-learning/10. protobuf/protobuf-test.cpp", "C++", 0, 0, 0, 0, 0, 0, 1, 1
"/home/sunny/workspace_private/3rd-test-learning/11. tic toc/tic_toc-test.cpp", "C++", 19, 0, 0, 0, 0, 9, 3, 31
"/home/sunny/workspace_private/3rd-test-learning/11. tic toc/tic_toc.hpp", "C++", 54, 0, 0, 0, 0, 8, 14, 76
"/home/sunny/workspace_private/3rd-test-learning/12. eigen/map-test.cpp", "C++", 14, 0, 0, 0, 0, 7, 4, 25
"/home/sunny/workspace_private/3rd-test-learning/13. boost-serialization/derived-base-serialization.cpp", "C++", 63, 0, 0, 0, 0, 14, 15, 92
"/home/sunny/workspace_private/3rd-test-learning/13. boost-serialization/simple-case-no-invasive.cpp", "C++", 47, 0, 0, 0, 0, 9, 12, 68
"/home/sunny/workspace_private/3rd-test-learning/13. boost-serialization/simple-case-test.cpp", "C++", 44, 0, 0, 0, 0, 14, 14, 72
"/home/sunny/workspace_private/3rd-test-learning/13. boost-serialization/stl-member-object.cpp", "C++", 69, 0, 0, 0, 0, 12, 21, 102
"/home/sunny/workspace_private/3rd-test-learning/14. random-generator/random_generator.cpp", "C++", 18, 0, 0, 0, 0, 12, 7, 37
"/home/sunny/workspace_private/3rd-test-learning/15. TBB/tbb_helloworld.cpp", "C++", 0, 0, 0, 0, 0, 8, 1, 9
"/home/sunny/workspace_private/3rd-test-learning/16. pcl/display/display.hpp", "C++", 20, 0, 0, 0, 0, 8, 6, 34
"/home/sunny/workspace_private/3rd-test-learning/16. pcl/filter/filter.hpp", "C++", 20, 0, 0, 0, 0, 11, 5, 36
"/home/sunny/workspace_private/3rd-test-learning/16. pcl/registration/icp_test.cpp", "C++", 47, 0, 0, 0, 0, 63, 28, 138
"/home/sunny/workspace_private/3rd-test-learning/17. openmp/omp_exercise1.cpp", "C++", 16, 0, 0, 0, 0, 8, 1, 25
"/home/sunny/workspace_private/3rd-test-learning/17. openmp/omp_exercise2.cpp", "C++", 0, 0, 0, 0, 0, 7, 1, 8
"/home/sunny/workspace_private/3rd-test-learning/19. sensor_funsion_hw/hw1_ceres_ndt/ceres_ndt.cpp", "C++", 53, 0, 0, 0, 0, 16, 26, 95
"/home/sunny/workspace_private/3rd-test-learning/19. sensor_funsion_hw/hw1_ceres_ndt/ceres_ndt_se3(likely to be wrong).h", "C++", 143, 0, 0, 0, 0, 11, 43, 197
"/home/sunny/workspace_private/3rd-test-learning/19. sensor_funsion_hw/hw1_ceres_ndt/ceres_ndt_se3.h", "C++", 161, 0, 0, 0, 0, 14, 48, 223
"/home/sunny/workspace_private/3rd-test-learning/19. sensor_funsion_hw/hw1_ceres_ndt/ceres_ndt_so3.h", "C++", 158, 0, 0, 0, 0, 9, 51, 218
"/home/sunny/workspace_private/3rd-test-learning/19. sensor_funsion_hw/hw1_ceres_ndt/filter.hpp", "C++", 20, 0, 0, 0, 0, 11, 5, 36
"/home/sunny/workspace_private/3rd-test-learning/2. rosbag-convert/rosbag_convert.cpp", "C++", 69, 0, 0, 0, 0, 12, 18, 99
"/home/sunny/workspace_private/3rd-test-learning/4. sophus/sophus_test.cpp", "C++", 24, 0, 0, 0, 0, 12, 17, 53
"/home/sunny/workspace_private/3rd-test-learning/5. gtest/gtest_1.cpp", "C++", 15, 0, 0, 0, 0, 8, 6, 29
"/home/sunny/workspace_private/3rd-test-learning/5. gtest/gtest_2.cpp", "C++", 18, 0, 0, 0, 0, 8, 13, 39
"/home/sunny/workspace_private/3rd-test-learning/5. gtest/gtest_3.cpp", "C++", 45, 0, 0, 0, 0, 9, 12, 66
"/home/sunny/workspace_private/3rd-test-learning/5. gtest/gtest_test_f.cpp", "C++", 45, 0, 0, 0, 0, 10, 19, 74
"/home/sunny/workspace_private/3rd-test-learning/6. yaml/test-config.yaml", "YAML", 0, 3, 0, 0, 0, 0, 0, 3
"/home/sunny/workspace_private/3rd-test-learning/6. yaml/yaml-test.cpp", "C++", 7, 0, 0, 0, 0, 7, 7, 21
"/home/sunny/workspace_private/3rd-test-learning/7. eigen/eigen-test-array-vector.cpp", "C++", 10, 0, 0, 0, 0, 10, 6, 26
"/home/sunny/workspace_private/3rd-test-learning/7. eigen/eigen_llt.cpp", "C++", 16, 0, 0, 0, 0, 8, 5, 29
"/home/sunny/workspace_private/3rd-test-learning/8. ceres/2nd-basic-test.cpp", "C++", 66, 0, 0, 0, 0, 12, 21, 99
"/home/sunny/workspace_private/3rd-test-learning/8. ceres/3rd-basic-test.cpp", "C++", 107, 0, 0, 0, 0, 15, 13, 135
"/home/sunny/workspace_private/3rd-test-learning/8. ceres/4th-basic-test.cpp", "C++", 127, 0, 0, 0, 0, 36, 21, 184
"/home/sunny/workspace_private/3rd-test-learning/8. ceres/5th-how-to-write-function-usable-in-ceres.cpp", "C++", 58, 0, 0, 0, 0, 18, 18, 94
"/home/sunny/workspace_private/3rd-test-learning/8. ceres/6th-a-value-return-function-for-autodiff.cpp", "C++", 58, 0, 0, 0, 0, 23, 17, 98
"/home/sunny/workspace_private/3rd-test-learning/8. ceres/7th-value-jacobian-return-function-for-autodiff.cpp", "C++", 55, 0, 0, 0, 0, 13, 16, 84
"/home/sunny/workspace_private/3rd-test-learning/8. ceres/8th-numericalDiff-example.cpp", "C++", 0, 0, 0, 0, 0, 7, 1, 8
"/home/sunny/workspace_private/3rd-test-learning/8. ceres/9th-analytic-derivation.cpp", "C++", 38, 0, 0, 0, 0, 16, 11, 65
"/home/sunny/workspace_private/3rd-test-learning/8. ceres/basic-test.cpp", "C++", 29, 0, 0, 0, 0, 22, 16, 67
"/home/sunny/workspace_private/3rd-test-learning/8. ceres/ceres_pnp/PNPSimulation.cpp", "C++", 138, 0, 0, 0, 0, 16, 46, 200
"/home/sunny/workspace_private/3rd-test-learning/8. ceres/ceres_pnp/PNPSimulation.h", "C++", 75, 0, 0, 0, 0, 3, 21, 99
"/home/sunny/workspace_private/3rd-test-learning/8. ceres/ceres_pnp/README.md", "Markdown", 0, 0, 0, 0, 13, 0, 9, 22
"/home/sunny/workspace_private/3rd-test-learning/8. ceres/ceres_pnp/Thirdparty/Eigen/src/Cholesky/LDLT.h", "C++", 399, 0, 0, 0, 0, 183, 88, 670
"/home/sunny/workspace_private/3rd-test-learning/8. ceres/ceres_pnp/Thirdparty/Eigen/src/Cholesky/LLT.h", "C++", 333, 0, 0, 0, 0, 136, 66, 535
"/home/sunny/workspace_private/3rd-test-learning/8. ceres/ceres_pnp/Thirdparty/Eigen/src/Cholesky/LLT_LAPACKE.h", "C++", 59, 0, 0, 0, 0, 31, 10, 100
"/home/sunny/workspace_private/3rd-test-learning/8. ceres/ceres_pnp/Thirdparty/Eigen/src/CholmodSupport/CholmodSupport.h", "C++", 410, 0, 0, 0, 0, 177, 96, 683
"/home/sunny/workspace_private/3rd-test-learning/8. ceres/ceres_pnp/Thirdparty/Eigen/src/Core/Array.h", "C++", 185, 0, 0, 0, 0, 102, 39, 326
"/home/sunny/workspace_private/3rd-test-learning/8. ceres/ceres_pnp/Thirdparty/Eigen/src/Core/ArrayBase.h", "C++", 137, 0, 0, 0, 0, 59, 31, 227
"/home/sunny/workspace_private/3rd-test-learning/8. ceres/ceres_pnp/Thirdparty/Eigen/src/Core/ArrayWrapper.h", "C++", 136, 0, 0, 0, 0, 38, 34, 208
"/home/sunny/workspace_private/3rd-test-learning/8. ceres/ceres_pnp/Thirdparty/Eigen/src/Core/Assign.h", "C++", 66, 0, 0, 0, 0, 10, 15, 91
"/home/sunny/workspace_private/3rd-test-learning/8. ceres/ceres_pnp/Thirdparty/Eigen/src/Core/AssignEvaluator.h", "C++", 678, 0, 0, 0, 0, 110, 131, 919
"/home/sunny/workspace_private/3rd-test-learning/8. ceres/ceres_pnp/Thirdparty/Eigen/src/Core/Assign_MKL.h", "C++", 122, 0, 0, 0, 0, 33, 22, 177
"/home/sunny/workspace_private/3rd-test-learning/8. ceres/ceres_pnp/Thirdparty/Eigen/src/Core/BandMatrix.h", "C++", 235, 0, 0, 0, 0, 60, 59, 354
"/home/sunny/workspace_private/3rd-test-learning/8. ceres/ceres_pnp/Thirdparty/Eigen/src/Core/Block.h", "C++", 313, 0, 0, 0, 0, 82, 58, 453
"/home/sunny/workspace_private/3rd-test-learning/8. ceres/ceres_pnp/Thirdparty/Eigen/src/Core/BooleanRedux.h", "C++", 112, 0, 0, 0, 0, 31, 20, 163
"/home/sunny/workspace_private/3rd-test-learning/8. ceres/ceres_pnp/Thirdparty/Eigen/src/Core/CommaInitializer.h", "C++", 98, 0, 0, 0, 0, 47, 16, 161
"/home/sunny/workspace_private/3rd-test-learning/8. ceres/ceres_pnp/Thirdparty/Eigen/src/Core/ConditionEstimator.h", "C++", 95, 0, 0, 0, 0, 66, 15, 176
"/home/sunny/workspace_private/3rd-test-learning/8. ceres/ceres_pnp/Thirdparty/Eigen/src/Core/CoreEvaluators.h", "C++", 1323, 0, 0, 0, 0, 113, 295, 1731
"/home/sunny/workspace_private/3rd-test-learning/8. ceres/ceres_pnp/Thirdparty/Eigen/src/Core/CoreIterators.h", "C++", 76, 0, 0, 0, 0, 32, 25, 133
"/home/sunny/workspace_private/3rd-test-learning/8. ceres/ceres_pnp/Thirdparty/Eigen/src/Core/CwiseBinaryOp.h", "C++", 118, 0, 0, 0, 0, 47, 20, 185
"/home/sunny/workspace_private/3rd-test-learning/8. ceres/ceres_pnp/Thirdparty/Eigen/src/Core/CwiseNullaryOp.h", "C++", 349, 0, 0, 0, 0, 454, 64, 867
"/home/sunny/workspace_private/3rd-test-learning/8. ceres/ceres_pnp/Thirdparty/Eigen/src/Core/CwiseTernaryOp.h", "C++", 125, 0, 0, 0, 0, 53, 20, 198
"/home/sunny/workspace_private/3rd-test-learning/8. ceres/ceres_pnp/Thirdparty/Eigen/src/Core/CwiseUnaryOp.h", "C++", 56, 0, 0, 0, 0, 32, 16, 104
"/home/sunny/workspace_private/3rd-test-learning/8. ceres/ceres_pnp/Thirdparty/Eigen/src/Core/CwiseUnaryView.h", "C++", 79, 0, 0, 0, 0, 27, 23, 129
"/home/sunny/workspace_private/3rd-test-learning/8. ceres/ceres_pnp/Thirdparty/Eigen/src/Core/DenseBase.h", "C++", 344, 0, 0, 0, 0, 174, 87, 605
"/home/sunny/workspace_private/3rd-test-learning/8. ceres/ceres_pnp/Thirdparty/Eigen/src/Core/DenseCoeffsBase.h", "C++", 368, 0, 0, 0, 0, 228, 86, 682
"/home/sunny/workspace_private/3rd-test-learning/8. ceres/ceres_pnp/Thirdparty/Eigen/src/Core/DenseStorage.h", "C++", 486, 0, 0, 0, 0, 39, 39, 564
"/home/sunny/workspace_private/3rd-test-learning/8. ceres/ceres_pnp/Thirdparty/Eigen/src/Core/Diagonal.h", "C++", 163, 0, 0, 0, 0, 62, 33, 258
"/home/sunny/workspace_private/3rd-test-learning/8. ceres/ceres_pnp/Thirdparty/Eigen/src/Core/DiagonalMatrix.h", "C++", 223, 0, 0, 0, 0, 72, 49, 344
"/home/sunny/workspace_private/3rd-test-learning/8. ceres/ceres_pnp/Thirdparty/Eigen/src/Core/DiagonalProduct.h", "C++", 12, 0, 0, 0, 0, 11, 6, 29
"/home/sunny/workspace_private/3rd-test-learning/8. ceres/ceres_pnp/Thirdparty/Eigen/src/Core/Dot.h", "C++", 178, 0, 0, 0, 0, 108, 30, 316
"/home/sunny/workspace_private/3rd-test-learning/8. ceres/ceres_pnp/Thirdparty/Eigen/src/Core/EigenBase.h", "C++", 77, 0, 0, 0, 0, 58, 21, 156
"/home/sunny/workspace_private/3rd-test-learning/8. ceres/ceres_pnp/Thirdparty/Eigen/src/Core/ForceAlignedAccess.h", "C++", 89, 0, 0, 0, 0, 32, 26, 147
"/home/sunny/workspace_private/3rd-test-learning/8. ceres/ceres_pnp/Thirdparty/Eigen/src/Core/Fuzzy.h", "C++", 90, 0, 0, 0, 0, 49, 17, 156
"/home/sunny/workspace_private/3rd-test-learning/8. ceres/ceres_pnp/Thirdparty/Eigen/src/Core/GeneralProduct.h", "C++", 317, 0, 0, 0, 0, 78, 60, 455
"/home/sunny/workspace_private/3rd-test-learning/8. ceres/ceres_pnp/Thirdparty/Eigen/src/Core/GenericPacketMath.h", "C++", 339, 0, 0, 0, 0, 158, 102, 599
"/home/sunny/workspace_private/3rd-test-learning/8. ceres/ceres_pnp/Thirdparty/Eigen/src/Core/GlobalFunctions.h", "C++", 124, 0, 0, 0, 0, 47, 18, 189
"/home/sunny/workspace_private/3rd-test-learning/8. ceres/ceres_pnp/Thirdparty/Eigen/src/Core/IO.h", "C++", 141, 0, 0, 0, 0, 76, 23, 240
"/home/sunny/workspace_private/3rd-test-learning/8. ceres/ceres_pnp/Thirdparty/Eigen/src/Core/Inverse.h", "C++", 68, 0, 0, 0, 0, 29, 22, 119
"/home/sunny/workspace_private/3rd-test-learning/8. ceres/ceres_pnp/Thirdparty/Eigen/src/Core/Map.h", "C++", 71, 0, 0, 0, 0, 77, 17, 165
"/home/sunny/workspace_private/3rd-test-learning/8. ceres/ceres_pnp/Thirdparty/Eigen/src/Core/MapBase.h", "C++", 196, 0, 0, 0, 0, 59, 45, 300
"/home/sunny/workspace_private/3rd-test-learning/8. ceres/ceres_pnp/Thirdparty/Eigen/src/Core/MathFunctions.h", "C++", 1298, 0, 0, 0, 0, 113, 257, 1668
"/home/sunny/workspace_private/3rd-test-learning/8. ceres/ceres_pnp/Thirdparty/Eigen/src/Core/MathFunctionsImpl.h", "C++", 37, 0, 0, 0, 0, 29, 13, 79
"/home/sunny/workspace_private/3rd-test-learning/8. ceres/ceres_pnp/Thirdparty/Eigen/src/Core/Matrix.h", "C++", 195, 0, 0, 0, 0, 223, 44, 462
"/home/sunny/workspace_private/3rd-test-learning/8. ceres/ceres_pnp/Thirdparty/Eigen/src/Core/MatrixBase.h", "C++", 336, 0, 0, 0, 0, 102, 93, 531
"/home/sunny/workspace_private/3rd-test-learning/8. ceres/ceres_pnp/Thirdparty/Eigen/src/Core/NestByValue.h", "C++", 67, 0, 0, 0, 0, 23, 21, 111
"/home/sunny/workspace_private/3rd-test-learning/8. ceres/ceres_pnp/Thirdparty/Eigen/src/Core/NoAlias.h", "C++", 45, 0, 0, 0, 0, 51, 13, 109
"/home/sunny/workspace_private/3rd-test-learning/8. ceres/ceres_pnp/Thirdparty/Eigen/src/Core/NumTraits.h", "C++", 160, 0, 0, 0, 0, 53, 34, 247
"/home/sunny/workspace_private/3rd-test-learning/8. ceres/ceres_pnp/Thirdparty/Eigen/src/Core/PermutationMatrix.h", "C++", 389, 0, 0, 0, 0, 157, 88, 634
"/home/sunny/workspace_private/3rd-test-learning/8. ceres/ceres_pnp/Thirdparty/Eigen/src/Core/PlainObjectBase.h", "C++", 681, 0, 0, 0, 0, 237, 106, 1024
"/home/sunny/workspace_private/3rd-test-learning/8. ceres/ceres_pnp/Thirdparty/Eigen/src/Core/Product.h", "C++", 122, 0, 0, 0, 0, 26, 39, 187
"/home/sunny/workspace_private/3rd-test-learning/8. ceres/ceres_pnp/Thirdparty/Eigen/src/Core/ProductEvaluators.h", "C++", 806, 0, 0, 0, 0, 129, 165, 1100
"/home/sunny/workspace_private/3rd-test-learning/8. ceres/ceres_pnp/Thirdparty/Eigen/src/Core/Random.h", "C++", 51, 0, 0, 0, 0, 117, 15, 183
"/home/sunny/workspace_private/3rd-test-learning/8. ceres/ceres_pnp/Thirdparty/Eigen/src/Core/Redux.h", "C++", 365, 0, 0, 0, 0, 70, 71, 506
"/home/sunny/workspace_private/3rd-test-learning/8. ceres/ceres_pnp/Thirdparty/Eigen/src/Core/Ref.h", "C++", 155, 0, 0, 0, 0, 89, 38, 282
"/home/sunny/workspace_private/3rd-test-learning/8. ceres/ceres_pnp/Thirdparty/Eigen/src/Core/Replicate.h", "C++", 85, 0, 0, 0, 0, 42, 16, 143
"/home/sunny/workspace_private/3rd-test-learning/8. ceres/ceres_pnp/Thirdparty/Eigen/src/Core/ReturnByValue.h", "C++", 72, 0, 0, 0, 0, 26, 20, 118
"/home/sunny/workspace_private/3rd-test-learning/8. ceres/ceres_pnp/Thirdparty/Eigen/src/Core/Reverse.h", "C++", 129, 0, 0, 0, 0, 54, 29, 212
"/home/sunny/workspace_private/3rd-test-learning/8. ceres/ceres_pnp/Thirdparty/Eigen/src/Core/Select.h", "C++", 102, 0, 0, 0, 0, 40, 21, 163
"/home/sunny/workspace_private/3rd-test-learning/8. ceres/ceres_pnp/Thirdparty/Eigen/src/Core/SelfAdjointView.h", "C++", 201, 0, 0, 0, 0, 99, 51, 351
"/home/sunny/workspace_private/3rd-test-learning/8. ceres/ceres_pnp/Thirdparty/Eigen/src/Core/SelfCwiseBinaryOp.h", "C++", 33, 0, 0, 0, 0, 9, 10, 52
"/home/sunny/workspace_private/3rd-test-learning/8. ceres/ceres_pnp/Thirdparty/Eigen/src/Core/Solve.h", "C++", 125, 0, 0, 0, 0, 28, 36, 189
"/home/sunny/workspace_private/3rd-test-learning/8. ceres/ceres_pnp/Thirdparty/Eigen/src/Core/SolveTriangular.h", "C++", 166, 0, 0, 0, 0, 19, 48, 233
"/home/sunny/workspace_private/3rd-test-learning/8. ceres/ceres_pnp/Thirdparty/Eigen/src/Core/SolverBase.h", "C++", 60, 0, 0, 0, 0, 48, 23, 131
"/home/sunny/workspace_private/3rd-test-learning/8. ceres/ceres_pnp/Thirdparty/Eigen/src/Core/StableNorm.h", "C++", 158, 0, 0, 0, 0, 42, 21, 221
"/home/sunny/workspace_private/3rd-test-learning/8. ceres/ceres_pnp/Thirdparty/Eigen/src/Core/Stride.h", "C++", 54, 0, 0, 0, 0, 45, 13, 112
"/home/sunny/workspace_private/3rd-test-learning/8. ceres/ceres_pnp/Thirdparty/Eigen/src/Core/Swap.h", "C++", 45, 0, 0, 0, 0, 10, 13, 68
"/home/sunny/workspace_private/3rd-test-learning/8. ceres/ceres_pnp/Thirdparty/Eigen/src/Core/Transpose.h", "C++", 227, 0, 0, 0, 0, 121, 56, 404
"/home/sunny/workspace_private/3rd-test-learning/8. ceres/ceres_pnp/Thirdparty/Eigen/src/Core/Transpositions.h", "C++", 229, 0, 0, 0, 0, 108, 71, 408
"/home/sunny/workspace_private/3rd-test-learning/8. ceres/ceres_pnp/Thirdparty/Eigen/src/Core/TriangularMatrix.h", "C++", 658, 0, 0, 0, 0, 182, 145, 985
"/home/sunny/workspace_private/3rd-test-learning/8. ceres/ceres_pnp/Thirdparty/Eigen/src/Core/VectorBlock.h", "C++", 43, 0, 0, 0, 0, 43, 11, 97
"/home/sunny/workspace_private/3rd-test-learning/8. ceres/ceres_pnp/Thirdparty/Eigen/src/Core/VectorwiseOp.h", "C++", 405, 0, 0, 0, 0, 206, 85, 696
"/home/sunny/workspace_private/3rd-test-learning/8. ceres/ceres_pnp/Thirdparty/Eigen/src/Core/Visitor.h", "C++", 184, 0, 0, 0, 0, 61, 29, 274
"/home/sunny/workspace_private/3rd-test-learning/8. ceres/ceres_pnp/Thirdparty/Eigen/src/Core/arch/AVX/Complex.h", "C++", 388, 0, 0, 0, 0, 13, 83, 484
"/home/sunny/workspace_private/3rd-test-learning/8. ceres/ceres_pnp/Thirdparty/Eigen/src/Core/arch/AVX/MathFunctions.h", "C++", 276, 0, 0, 0, 0, 92, 72, 440
"/home/sunny/workspace_private/3rd-test-learning/8. ceres/ceres_pnp/Thirdparty/Eigen/src/Core/arch/AVX/PacketMath.h", "C++", 504, 0, 0, 0, 0, 42, 88, 634
"/home/sunny/workspace_private/3rd-test-learning/8. ceres/ceres_pnp/Thirdparty/Eigen/src/Core/arch/AVX/TypeCasting.h", "C++", 29, 0, 0, 0, 0, 10, 13, 52
"/home/sunny/workspace_private/3rd-test-learning/8. ceres/ceres_pnp/Thirdparty/Eigen/src/Core/arch/AVX512/MathFunctions.h", "C++", 194, 0, 0, 0, 0, 143, 60, 397
"/home/sunny/workspace_private/3rd-test-learning/8. ceres/ceres_pnp/Thirdparty/Eigen/src/Core/arch/AVX512/PacketMath.h", "C++", 1080, 0, 0, 0, 0, 33, 170, 1283
"/home/sunny/workspace_private/3rd-test-learning/8. ceres/ceres_pnp/Thirdparty/Eigen/src/Core/arch/AltiVec/Complex.h", "C++", 362, 0, 0, 0, 0, 24, 76, 462
"/home/sunny/workspace_private/3rd-test-learning/8. ceres/ceres_pnp/Thirdparty/Eigen/src/Core/arch/AltiVec/MathFunctions.h", "C++", 215, 0, 0, 0, 0, 45, 63, 323
"/home/sunny/workspace_private/3rd-test-learning/8. ceres/ceres_pnp/Thirdparty/Eigen/src/Core/arch/AltiVec/PacketMath.h", "C++", 837, 0, 0, 0, 0, 53, 144, 1034
"/home/sunny/workspace_private/3rd-test-learning/8. ceres/ceres_pnp/Thirdparty/Eigen/src/Core/arch/CUDA/Complex.h", "C++", 60, 0, 0, 0, 0, 18, 26, 104
"/home/sunny/workspace_private/3rd-test-learning/8. ceres/ceres_pnp/Thirdparty/Eigen/src/Core/arch/CUDA/Half.h", "C++", 464, 0, 0, 0, 0, 64, 77, 605
"/home/sunny/workspace_private/3rd-test-learning/8. ceres/ceres_pnp/Thirdparty/Eigen/src/Core/arch/CUDA/MathFunctions.h", "C++", 72, 0, 0, 0, 0, 11, 21, 104
"/home/sunny/workspace_private/3rd-test-learning/8. ceres/ceres_pnp/Thirdparty/Eigen/src/Core/arch/CUDA/PacketMath.h", "C++", 268, 0, 0, 0, 0, 11, 55, 334
"/home/sunny/workspace_private/3rd-test-learning/8. ceres/ceres_pnp/Thirdparty/Eigen/src/Core/arch/CUDA/PacketMathHalf.h", "C++", 964, 0, 0, 0, 0, 15, 154, 1133
"/home/sunny/workspace_private/3rd-test-learning/8. ceres/ceres_pnp/Thirdparty/Eigen/src/Core/arch/CUDA/TypeCasting.h", "C++", 164, 0, 0, 0, 0, 11, 38, 213
"/home/sunny/workspace_private/3rd-test-learning/8. ceres/ceres_pnp/Thirdparty/Eigen/src/Core/arch/Default/Settings.h", "C++", 15, 0, 0, 0, 0, 25, 10, 50
"/home/sunny/workspace_private/3rd-test-learning/8. ceres/ceres_pnp/Thirdparty/Eigen/src/Core/arch/NEON/Complex.h", "C++", 361, 0, 0, 0, 0, 40, 86, 487
"/home/sunny/workspace_private/3rd-test-learning/8. ceres/ceres_pnp/Thirdparty/Eigen/src/Core/arch/NEON/MathFunctions.h", "C++", 59, 0, 0, 0, 0, 13, 20, 92
"/home/sunny/workspace_private/3rd-test-learning/8. ceres/ceres_pnp/Thirdparty/Eigen/src/Core/arch/NEON/PacketMath.h", "C++", 511, 0, 0, 0, 0, 86, 130, 727
"/home/sunny/workspace_private/3rd-test-learning/8. ceres/ceres_pnp/Thirdparty/Eigen/src/Core/arch/SSE/Complex.h", "C++", 400, 0, 0, 0, 0, 27, 77, 504
"/home/sunny/workspace_private/3rd-test-learning/8. ceres/ceres_pnp/Thirdparty/Eigen/src/Core/arch/SSE/MathFunctions.h", "C++", 361, 0, 0, 0, 0, 95, 107, 563
"/home/sunny/workspace_private/3rd-test-learning/8. ceres/ceres_pnp/Thirdparty/Eigen/src/Core/arch/SSE/PacketMath.h", "C++", 711, 0, 0, 0, 0, 75, 94, 880
"/home/sunny/workspace_private/3rd-test-learning/8. ceres/ceres_pnp/Thirdparty/Eigen/src/Core/arch/SSE/TypeCasting.h", "C++", 51, 0, 0, 0, 0, 9, 18, 78
"/home/sunny/workspace_private/3rd-test-learning/8. ceres/ceres_pnp/Thirdparty/Eigen/src/Core/arch/ZVector/Complex.h", "C++", 321, 0, 0, 0, 0, 18, 56, 395
"/home/sunny/workspace_private/3rd-test-learning/8. ceres/ceres_pnp/Thirdparty/Eigen/src/Core/arch/ZVector/MathFunctions.h", "C++", 87, 0, 0, 0, 0, 19, 32, 138
"/home/sunny/workspace_private/3rd-test-learning/8. ceres/ceres_pnp/Thirdparty/Eigen/src/Core/arch/ZVector/PacketMath.h", "C++", 762, 0, 0, 0, 0, 55, 129, 946
"/home/sunny/workspace_private/3rd-test-learning/8. ceres/ceres_pnp/Thirdparty/Eigen/src/Core/functors/AssignmentFunctors.h", "C++", 98, 0, 0, 0, 0, 45, 26, 169
"/home/sunny/workspace_private/3rd-test-learning/8. ceres/ceres_pnp/Thirdparty/Eigen/src/Core/functors/BinaryFunctors.h", "C++", 343, 0, 0, 0, 0, 85, 55, 483
"/home/sunny/workspace_private/3rd-test-learning/8. ceres/ceres_pnp/Thirdparty/Eigen/src/Core/functors/NullaryFunctors.h", "C++", 141, 0, 0, 0, 0, 22, 27, 190
"/home/sunny/workspace_private/3rd-test-learning/8. ceres/ceres_pnp/Thirdparty/Eigen/src/Core/functors/StlFunctors.h", "C++", 86, 0, 0, 0, 0, 12, 35, 133
"/home/sunny/workspace_private/3rd-test-learning/8. ceres/ceres_pnp/Thirdparty/Eigen/src/Core/functors/TernaryFunctors.h", "C++", 7, 0, 0, 0, 0, 9, 10, 26
"/home/sunny/workspace_private/3rd-test-learning/8. ceres/ceres_pnp/Thirdparty/Eigen/src/Core/functors/UnaryFunctors.h", "C++", 576, 0, 0, 0, 0, 206, 49, 831
"/home/sunny/workspace_private/3rd-test-learning/8. ceres/ceres_pnp/Thirdparty/Eigen/src/Core/products/GeneralBlockPanelKernel.h", "C++", 1552, 0, 0, 0, 0, 337, 261, 2150
"/home/sunny/workspace_private/3rd-test-learning/8. ceres/ceres_pnp/Thirdparty/Eigen/src/Core/products/GeneralMatrixMatrix.h", "C++", 357, 0, 0, 0, 0, 46, 90, 493
"/home/sunny/workspace_private/3rd-test-learning/8. ceres/ceres_pnp/Thirdparty/Eigen/src/Core/products/GeneralMatrixMatrixTriangular.h", "C++", 206, 0, 0, 0, 0, 38, 57, 301
"/home/sunny/workspace_private/3rd-test-learning/8. ceres/ceres_pnp/Thirdparty/Eigen/src/Core/products/GeneralMatrixMatrixTriangular_BLAS.h", "C++", 85, 0, 0, 0, 0, 40, 17, 142
"/home/sunny/workspace_private/3rd-test-learning/8. ceres/ceres_pnp/Thirdparty/Eigen/src/Core/products/GeneralMatrixMatrix_BLAS.h", "C++", 67, 0, 0, 0, 0, 38, 11, 116
"/home/sunny/workspace_private/3rd-test-learning/8. ceres/ceres_pnp/Thirdparty/Eigen/src/Core/products/GeneralMatrixVector.h", "C++", 323, 0, 0, 0, 0, 40, 43, 406
"/home/sunny/workspace_private/3rd-test-learning/8. ceres/ceres_pnp/Thirdparty/Eigen/src/Core/products/GeneralMatrixVector_BLAS.h", "C++", 78, 0, 0, 0, 0, 38, 14, 130
"/home/sunny/workspace_private/3rd-test-learning/8. ceres/ceres_pnp/Thirdparty/Eigen/src/Core/products/Parallelizer.h", "C++", 99, 0, 0, 0, 0, 33, 31, 163
"/home/sunny/workspace_private/3rd-test-learning/8. ceres/ceres_pnp/Thirdparty/Eigen/src/Core/products/SelfadjointMatrixMatrix.h", "C++", 403, 0, 0, 0, 0, 51, 68, 522
"/home/sunny/workspace_private/3rd-test-learning/8. ceres/ceres_pnp/Thirdparty/Eigen/src/Core/products/SelfadjointMatrixMatrix_BLAS.h", "C++", 224, 0, 0, 0, 0, 33, 19, 276
"/home/sunny/workspace_private/3rd-test-learning/8. ceres/ceres_pnp/Thirdparty/Eigen/src/Core/products/SelfadjointMatrixVector.h", "C++", 193, 0, 0, 0, 0, 19, 49, 261
"/home/sunny/workspace_private/3rd-test-learning/8. ceres/ceres_pnp/Thirdparty/Eigen/src/Core/products/SelfadjointMatrixVector_BLAS.h", "C++", 63, 0, 0, 0, 0, 35, 14, 112
"/home/sunny/workspace_private/3rd-test-learning/8. ceres/ceres_pnp/Thirdparty/Eigen/src/Core/products/SelfadjointProduct.h", "C++", 93, 0, 0, 0, 0, 14, 27, 134
"/home/sunny/workspace_private/3rd-test-learning/8. ceres/ceres_pnp/Thirdparty/Eigen/src/Core/products/SelfadjointRank2Update.h", "C++", 63, 0, 0, 0, 0, 13, 18, 94
"/home/sunny/workspace_private/3rd-test-learning/8. ceres/ceres_pnp/Thirdparty/Eigen/src/Core/products/TriangularMatrixMatrix.h", "C++", 318, 0, 0, 0, 0, 63, 61, 442
"/home/sunny/workspace_private/3rd-test-learning/8. ceres/ceres_pnp/Thirdparty/Eigen/src/Core/products/TriangularMatrixMatrix_BLAS.h", "C++", 253, 0, 0, 0, 0, 34, 16, 303
"/home/sunny/workspace_private/3rd-test-learning/8. ceres/ceres_pnp/Thirdparty/Eigen/src/Core/products/TriangularMatrixVector.h", "C++", 268, 0, 0, 0, 0, 14, 55, 337
"/home/sunny/workspace_private/3rd-test-learning/8. ceres/ceres_pnp/Thirdparty/Eigen/src/Core/products/TriangularMatrixVector_BLAS.h", "C++", 189, 0, 0, 0, 0, 37, 16, 242
"/home/sunny/workspace_private/3rd-test-learning/8. ceres/ceres_pnp/Thirdparty/Eigen/src/Core/products/TriangularSolverMatrix.h", "C++", 248, 0, 0, 0, 0, 40, 48, 336
"/home/sunny/workspace_private/3rd-test-learning/8. ceres/ceres_pnp/Thirdparty/Eigen/src/Core/products/TriangularSolverMatrix_BLAS.h", "C++", 106, 0, 0, 0, 0, 33, 13, 152
"/home/sunny/workspace_private/3rd-test-learning/8. ceres/ceres_pnp/Thirdparty/Eigen/src/Core/products/TriangularSolverVector.h", "C++", 111, 0, 0, 0, 0, 16, 19, 146
"/home/sunny/workspace_private/3rd-test-learning/8. ceres/ceres_pnp/Thirdparty/Eigen/src/Core/util/BlasUtil.h", "C++", 310, 0, 0, 0, 0, 21, 73, 404
"/home/sunny/workspace_private/3rd-test-learning/8. ceres/ceres_pnp/Thirdparty/Eigen/src/Core/util/Constants.h", "C++", 203, 0, 0, 0, 0, 287, 58, 548
"/home/sunny/workspace_private/3rd-test-learning/8. ceres/ceres_pnp/Thirdparty/Eigen/src/Core/util/DisableStupidWarnings.h", "C++", 42, 0, 0, 0, 0, 27, 9, 78
"/home/sunny/workspace_private/3rd-test-learning/8. ceres/ceres_pnp/Thirdparty/Eigen/src/Core/util/ForwardDeclarations.h", "C++", 223, 0, 0, 0, 0, 36, 44, 303
"/home/sunny/workspace_private/3rd-test-learning/8. ceres/ceres_pnp/Thirdparty/Eigen/src/Core/util/MKL_support.h", "C++", 75, 0, 0, 0, 0, 35, 19, 129
"/home/sunny/workspace_private/3rd-test-learning/8. ceres/ceres_pnp/Thirdparty/Eigen/src/Core/util/Macros.h", "C++", 669, 0, 0, 0, 0, 178, 158, 1005
"/home/sunny/workspace_private/3rd-test-learning/8. ceres/ceres_pnp/Thirdparty/Eigen/src/Core/util/Memory.h", "C++", 681, 0, 0, 0, 0, 186, 111, 978
"/home/sunny/workspace_private/3rd-test-learning/8. ceres/ceres_pnp/Thirdparty/Eigen/src/Core/util/Meta.h", "C++", 360, 0, 0, 0, 0, 55, 78, 493
"/home/sunny/workspace_private/3rd-test-learning/8. ceres/ceres_pnp/Thirdparty/Eigen/src/Core/util/NonMPL2.h", "C++", 3, 0, 0, 0, 0, 0, 1, 4
"/home/sunny/workspace_private/3rd-test-learning/8. ceres/ceres_pnp/Thirdparty/Eigen/src/Core/util/ReenableStupidWarnings.h", "C++", 16, 0, 0, 0, 0, 7, 5, 28
"/home/sunny/workspace_private/3rd-test-learning/8. ceres/ceres_pnp/Thirdparty/Eigen/src/Core/util/StaticAssert.h", "C++", 144, 0, 0, 0, 0, 35, 38, 217
"/home/sunny/workspace_private/3rd-test-learning/8. ceres/ceres_pnp/Thirdparty/Eigen/src/Core/util/XprHelper.h", "C++", 547, 0, 0, 0, 0, 162, 113, 822
"/home/sunny/workspace_private/3rd-test-learning/8. ceres/ceres_pnp/Thirdparty/Eigen/src/Eigenvalues/ComplexEigenSolver.h", "C++", 155, 0, 0, 0, 0, 152, 38, 345
"/home/sunny/workspace_private/3rd-test-learning/8. ceres/ceres_pnp/Thirdparty/Eigen/src/Eigenvalues/ComplexSchur.h", "C++", 231, 0, 0, 0, 0, 179, 50, 460
"/home/sunny/workspace_private/3rd-test-learning/8. ceres/ceres_pnp/Thirdparty/Eigen/src/Eigenvalues/ComplexSchur_LAPACKE.h", "C++", 52, 0, 0, 0, 0, 32, 8, 92
"/home/sunny/workspace_private/3rd-test-learning/8. ceres/ceres_pnp/Thirdparty/Eigen/src/Eigenvalues/EigenSolver.h", "C++", 345, 0, 0, 0, 0, 221, 57, 623
"/home/sunny/workspace_private/3rd-test-learning/8. ceres/ceres_pnp/Thirdparty/Eigen/src/Eigenvalues/GeneralizedEigenSolver.h", "C++", 203, 0, 0, 0, 0, 180, 37, 420
"/home/sunny/workspace_private/3rd-test-learning/8. ceres/ceres_pnp/Thirdparty/Eigen/src/Eigenvalues/GeneralizedSelfAdjointEigenSolver.h", "C++", 70, 0, 0, 0, 0, 130, 27, 227
"/home/sunny/workspace_private/3rd-test-learning/8. ceres/ceres_pnp/Thirdparty/Eigen/src/Eigenvalues/HessenbergDecomposition.h", "C++", 138, 0, 0, 0, 0, 202, 35, 375
"/home/sunny/workspace_private/3rd-test-learning/8. ceres/ceres_pnp/Thirdparty/Eigen/src/Eigenvalues/MatrixBaseEigenvalues.h", "C++", 63, 0, 0, 0, 0, 83, 15, 161
"/home/sunny/workspace_private/3rd-test-learning/8. ceres/ceres_pnp/Thirdparty/Eigen/src/Eigenvalues/RealQZ.h", "C++", 432, 0, 0, 0, 0, 162, 61, 655
"/home/sunny/workspace_private/3rd-test-learning/8. ceres/ceres_pnp/Thirdparty/Eigen/src/Eigenvalues/RealSchur.h", "C++", 318, 0, 0, 0, 0, 161, 56, 535
"/home/sunny/workspace_private/3rd-test-learning/8. ceres/ceres_pnp/Thirdparty/Eigen/src/Eigenvalues/RealSchur_LAPACKE.h", "C++", 38, 0, 0, 0, 0, 32, 8, 78
"/home/sunny/workspace_private/3rd-test-learning/8. ceres/ceres_pnp/Thirdparty/Eigen/src/Eigenvalues/SelfAdjointEigenSolver.h", "C++", 455, 0, 0, 0, 0, 317, 98, 870
"/home/sunny/workspace_private/3rd-test-learning/8. ceres/ceres_pnp/Thirdparty/Eigen/src/Eigenvalues/SelfAdjointEigenSolver_LAPACKE.h", "C++", 49, 0, 0, 0, 0, 32, 10, 91
"/home/sunny/workspace_private/3rd-test-learning/8. ceres/ceres_pnp/Thirdparty/Eigen/src/Eigenvalues/Tridiagonalization.h", "C++", 237, 0, 0, 0, 0, 271, 49, 557
"/home/sunny/workspace_private/3rd-test-learning/8. ceres/ceres_pnp/Thirdparty/Eigen/src/Geometry/AlignedBox.h", "C++", 212, 0, 0, 0, 0, 125, 56, 393
"/home/sunny/workspace_private/3rd-test-learning/8. ceres/ceres_pnp/Thirdparty/Eigen/src/Geometry/AngleAxis.h", "C++", 126, 0, 0, 0, 0, 84, 38, 248
"/home/sunny/workspace_private/3rd-test-learning/8. ceres/ceres_pnp/Thirdparty/Eigen/src/Geometry/EulerAngles.h", "C++", 65, 0, 0, 0, 0, 38, 12, 115
"/home/sunny/workspace_private/3rd-test-learning/8. ceres/ceres_pnp/Thirdparty/Eigen/src/Geometry/Homogeneous.h", "C++", 355, 0, 0, 0, 0, 82, 61, 498
"/home/sunny/workspace_private/3rd-test-learning/8. ceres/ceres_pnp/Thirdparty/Eigen/src/Geometry/Hyperplane.h", "C++", 144, 0, 0, 0, 0, 105, 34, 283
"/home/sunny/workspace_private/3rd-test-learning/8. ceres/ceres_pnp/Thirdparty/Eigen/src/Geometry/OrthoMethods.h", "C++", 151, 0, 0, 0, 0, 59, 25, 235
"/home/sunny/workspace_private/3rd-test-learning/8. ceres/ceres_pnp/Thirdparty/Eigen/src/Geometry/ParametrizedLine.h", "C++", 125, 0, 0, 0, 0, 73, 35, 233
"/home/sunny/workspace_private/3rd-test-learning/8. ceres/ceres_pnp/Thirdparty/Eigen/src/Geometry/Quaternion.h", "C++", 437, 0, 0, 0, 0, 261, 114, 812
"/home/sunny/workspace_private/3rd-test-learning/8. ceres/ceres_pnp/Thirdparty/Eigen/src/Geometry/Rotation2D.h", "C++", 94, 0, 0, 0, 0, 69, 37, 200
"/home/sunny/workspace_private/3rd-test-learning/8. ceres/ceres_pnp/Thirdparty/Eigen/src/Geometry/RotationBase.h", "C++", 115, 0, 0, 0, 0, 61, 31, 207
"/home/sunny/workspace_private/3rd-test-learning/8. ceres/ceres_pnp/Thirdparty/Eigen/src/Geometry/Scaling.h", "C++", 79, 0, 0, 0, 0, 64, 28, 171
"/home/sunny/workspace_private/3rd-test-learning/8. ceres/ceres_pnp/Thirdparty/Eigen/src/Geometry/Transform.h", "C++", 936, 0, 0, 0, 0, 440, 167, 1543
"/home/sunny/workspace_private/3rd-test-learning/8. ceres/ceres_pnp/Thirdparty/Eigen/src/Geometry/Translation.h", "C++", 118, 0, 0, 0, 0, 60, 31, 209
"/home/sunny/workspace_private/3rd-test-learning/8. ceres/ceres_pnp/Thirdparty/Eigen/src/Geometry/Umeyama.h", "C++", 67, 0, 0, 0, 0, 69, 31, 167
"/home/sunny/workspace_private/3rd-test-learning/8. ceres/ceres_pnp/Thirdparty/Eigen/src/Geometry/arch/Geometry_SSE.h", "C++", 99, 0, 0, 0, 0, 20, 23, 142
"/home/sunny/workspace_private/3rd-test-learning/8. ceres/ceres_pnp/Thirdparty/Eigen/src/Householder/BlockHouseholder.h", "C++", 40, 0, 0, 0, 0, 46, 17, 103
"/home/sunny/workspace_private/3rd-test-learning/8. ceres/ceres_pnp/Thirdparty/Eigen/src/Householder/Householder.h", "C++", 90, 0, 0, 0, 0, 70, 13, 173
"/home/sunny/workspace_private/3rd-test-learning/8. ceres/ceres_pnp/Thirdparty/Eigen/src/Householder/HouseholderSequence.h", "C++", 267, 0, 0, 0, 0, 157, 47, 471
"/home/sunny/workspace_private/3rd-test-learning/8. ceres/ceres_pnp/Thirdparty/Eigen/src/IterativeLinearSolvers/BasicPreconditioners.h", "C++", 126, 0, 0, 0, 0, 54, 32, 212
"/home/sunny/workspace_private/3rd-test-learning/8. ceres/ceres_pnp/Thirdparty/Eigen/src/IterativeLinearSolvers/BiCGSTAB.h", "C++", 130, 0, 0, 0, 0, 65, 34, 229
"/home/sunny/workspace_private/3rd-test-learning/8. ceres/ceres_pnp/Thirdparty/Eigen/src/IterativeLinearSolvers/ConjugateGradient.h", "C++", 134, 0, 0, 0, 0, 77, 35, 246
"/home/sunny/workspace_private/3rd-test-learning/8. ceres/ceres_pnp/Thirdparty/Eigen/src/IterativeLinearSolvers/IncompleteCholesky.h", "C++", 256, 0, 0, 0, 0, 101, 44, 401
"/home/sunny/workspace_private/3rd-test-learning/8. ceres/ceres_pnp/Thirdparty/Eigen/src/IterativeLinearSolvers/IncompleteLUT.h", "C++", 300, 0, 0, 0, 0, 106, 57, 463
"/home/sunny/workspace_private/3rd-test-learning/8. ceres/ceres_pnp/Thirdparty/Eigen/src/IterativeLinearSolvers/IterativeSolverBase.h", "C++", 254, 0, 0, 0, 0, 82, 59, 395
"/home/sunny/workspace_private/3rd-test-learning/8. ceres/ceres_pnp/Thirdparty/Eigen/src/IterativeLinearSolvers/LeastSquareConjugateGradient.h", "C++", 117, 0, 0, 0, 0, 67, 33, 217
"/home/sunny/workspace_private/3rd-test-learning/8. ceres/ceres_pnp/Thirdparty/Eigen/src/IterativeLinearSolvers/SolveWithGuess.h", "C++", 69, 0, 0, 0, 0, 23, 24, 116
"/home/sunny/workspace_private/3rd-test-learning/8. ceres/ceres_pnp/Thirdparty/Eigen/src/Jacobi/Jacobi.h", "C++", 299, 0, 0, 0, 0, 89, 46, 434
"/home/sunny/workspace_private/3rd-test-learning/8. ceres/ceres_pnp/Thirdparty/Eigen/src/LU/Determinant.h", "C++", 74, 0, 0, 0, 0, 13, 15, 102
"/home/sunny/workspace_private/3rd-test-learning/8. ceres/ceres_pnp/Thirdparty/Eigen/src/LU/FullPivLU.h", "C++", 459, 0, 0, 0, 0, 324, 109, 892
"/home/sunny/workspace_private/3rd-test-learning/8. ceres/ceres_pnp/Thirdparty/Eigen/src/LU/InverseImpl.h", "C++", 292, 0, 0, 0, 0, 84, 40, 416
"/home/sunny/workspace_private/3rd-test-learning/8. ceres/ceres_pnp/Thirdparty/Eigen/src/LU/PartialPivLU.h", "C++", 319, 0, 0, 0, 0, 213, 80, 612
"/home/sunny/workspace_private/3rd-test-learning/8. ceres/ceres_pnp/Thirdparty/Eigen/src/LU/PartialPivLU_LAPACKE.h", "C++", 42, 0, 0, 0, 0, 32, 10, 84
"/home/sunny/workspace_private/3rd-test-learning/8. ceres/ceres_pnp/Thirdparty/Eigen/src/LU/arch/Inverse_SSE.h", "C++", 207, 0, 0, 0, 0, 76, 56, 339
"/home/sunny/workspace_private/3rd-test-learning/8. ceres/ceres_pnp/Thirdparty/Eigen/src/MetisSupport/MetisSupport.h", "C++", 94, 0, 0, 0, 0, 31, 13, 138
"/home/sunny/workspace_private/3rd-test-learning/8. ceres/ceres_pnp/Thirdparty/Eigen/src/OrderingMethods/Amd.h", "C++", 366, 0, 0, 0, 0, 48, 32, 446
"/home/sunny/workspace_private/3rd-test-learning/8. ceres/ceres_pnp/Thirdparty/Eigen/src/OrderingMethods/Eigen_Colamd.h", "C++", 1075, 0, 0, 0, 0, 481, 288, 1844
"/home/sunny/workspace_private/3rd-test-learning/8. ceres/ceres_pnp/Thirdparty/Eigen/src/OrderingMethods/Ordering.h", "C++", 79, 0, 0, 0, 0, 54, 25, 158
"/home/sunny/workspace_private/3rd-test-learning/8. ceres/ceres_pnp/Thirdparty/Eigen/src/PaStiXSupport/PaStiXSupport.h", "C++", 440, 0, 0, 0, 0, 151, 88, 679
"/home/sunny/workspace_private/3rd-test-learning/8. ceres/ceres_pnp/Thirdparty/Eigen/src/PardisoSupport/PardisoSupport.h", "C++", 353, 0, 0, 0, 0, 121, 70, 544
"/home/sunny/workspace_private/3rd-test-learning/8. ceres/ceres_pnp/Thirdparty/Eigen/src/QR/ColPivHouseholderQR.h", "C++", 341, 0, 0, 0, 0, 234, 79, 654
"/home/sunny/workspace_private/3rd-test-learning/8. ceres/ceres_pnp/Thirdparty/Eigen/src/QR/ColPivHouseholderQR_LAPACKE.h", "C++", 56, 0, 0, 0, 0, 33, 9, 98
"/home/sunny/workspace_private/3rd-test-learning/8. ceres/ceres_pnp/Thirdparty/Eigen/src/QR/CompleteOrthogonalDecomposition.h", "C++", 243, 0, 0, 0, 0, 259, 61, 563
"/home/sunny/workspace_private/3rd-test-learning/8. ceres/ceres_pnp/Thirdparty/Eigen/src/QR/FullPivHouseholderQR.h", "C++", 379, 0, 0, 0, 0, 217, 81, 677
"/home/sunny/workspace_private/3rd-test-learning/8. ceres/ceres_pnp/Thirdparty/Eigen/src/QR/HouseholderQR.h", "C++", 209, 0, 0, 0, 0, 145, 56, 410
"/home/sunny/workspace_private/3rd-test-learning/8. ceres/ceres_pnp/Thirdparty/Eigen/src/QR/HouseholderQR_LAPACKE.h", "C++", 26, 0, 0, 0, 0, 33, 10, 69
"/home/sunny/workspace_private/3rd-test-learning/8. ceres/ceres_pnp/Thirdparty/Eigen/src/SPQRSupport/SuiteSparseQRSupport.h", "C++", 217, 0, 0, 0, 0, 69, 28, 314
"/home/sunny/workspace_private/3rd-test-learning/8. ceres/ceres_pnp/Thirdparty/Eigen/src/SVD/BDCSVD.h", "C++", 890, 0, 0, 0, 0, 202, 139, 1231
"/home/sunny/workspace_private/3rd-test-learning/8. ceres/ceres_pnp/Thirdparty/Eigen/src/SVD/JacobiSVD.h", "C++", 570, 0, 0, 0, 0, 146, 85, 801
"/home/sunny/workspace_private/3rd-test-learning/8. ceres/ceres_pnp/Thirdparty/Eigen/src/SVD/JacobiSVD_LAPACKE.h", "C++", 50, 0, 0, 0, 0, 32, 9, 91
"/home/sunny/workspace_private/3rd-test-learning/8. ceres/ceres_pnp/Thirdparty/Eigen/src/SVD/SVDBase.h", "C++", 164, 0, 0, 0, 0, 115, 35, 314
"/home/sunny/workspace_private/3rd-test-learning/8. ceres/ceres_pnp/Thirdparty/Eigen/src/SVD/UpperBidiagonalization.h", "C++", 267, 0, 0, 0, 0, 84, 62, 413
"/home/sunny/workspace_private/3rd-test-learning/8. ceres/ceres_pnp/Thirdparty/Eigen/src/SparseCholesky/SimplicialCholesky.h", "C++", 458, 0, 0, 0, 0, 145, 87, 690
"/home/sunny/workspace_private/3rd-test-learning/8. ceres/ceres_pnp/Thirdparty/Eigen/src/SparseCholesky/SimplicialCholesky_impl.h", "C++", 128, 0, 0, 0, 0, 47, 25, 200
"/home/sunny/workspace_private/3rd-test-learning/8. ceres/ceres_pnp/Thirdparty/Eigen/src/SparseCore/AmbiVector.h", "C++", 301, 0, 0, 0, 0, 38, 39, 378
"/home/sunny/workspace_private/3rd-test-learning/8. ceres/ceres_pnp/Thirdparty/Eigen/src/SparseCore/CompressedStorage.h", "C++", 195, 0, 0, 0, 0, 26, 38, 259
"/home/sunny/workspace_private/3rd-test-learning/8. ceres/ceres_pnp/Thirdparty/Eigen/src/SparseCore/ConservativeSparseSparseProduct.h", "C++", 268, 0, 0, 0, 0, 31, 47, 346
"/home/sunny/workspace_private/3rd-test-learning/8. ceres/ceres_pnp/Thirdparty/Eigen/src/SparseCore/MappedSparseMatrix.h", "C++", 34, 0, 0, 0, 0, 19, 15, 68
"/home/sunny/workspace_private/3rd-test-learning/8. ceres/ceres_pnp/Thirdparty/Eigen/src/SparseCore/SparseAssign.h", "C++", 168, 0, 0, 0, 0, 16, 36, 220
"/home/sunny/workspace_private/3rd-test-learning/8. ceres/ceres_pnp/Thirdparty/Eigen/src/SparseCore/SparseBlock.h", "C++", 447, 0, 0, 0, 0, 48, 109, 604
"/home/sunny/workspace_private/3rd-test-learning/8. ceres/ceres_pnp/Thirdparty/Eigen/src/SparseCore/SparseColEtree.h", "C++", 123, 0, 0, 0, 0, 64, 20, 207
"/home/sunny/workspace_private/3rd-test-learning/8. ceres/ceres_pnp/Thirdparty/Eigen/src/SparseCore/SparseCompressedBase.h", "C++", 222, 0, 0, 0, 0, 65, 55, 342
"/home/sunny/workspace_private/3rd-test-learning/8. ceres/ceres_pnp/Thirdparty/Eigen/src/SparseCore/SparseCwiseBinaryOp.h", "C++", 563, 0, 0, 0, 0, 42, 108, 713
"/home/sunny/workspace_private/3rd-test-learning/8. ceres/ceres_pnp/Thirdparty/Eigen/src/SparseCore/SparseCwiseUnaryOp.h", "C++", 109, 0, 0, 0, 0, 8, 32, 149
"/home/sunny/workspace_private/3rd-test-learning/8. ceres/ceres_pnp/Thirdparty/Eigen/src/SparseCore/SparseDenseProduct.h", "C++", 246, 0, 0, 0, 0, 26, 49, 321
"/home/sunny/workspace_private/3rd-test-learning/8. ceres/ceres_pnp/Thirdparty/Eigen/src/SparseCore/SparseDiagonalProduct.h", "C++", 88, 0, 0, 0, 0, 19, 28, 135
"/home/sunny/workspace_private/3rd-test-learning/8. ceres/ceres_pnp/Thirdparty/Eigen/src/SparseCore/SparseDot.h", "C++", 76, 0, 0, 0, 0, 8, 15, 99
"/home/sunny/workspace_private/3rd-test-learning/8. ceres/ceres_pnp/Thirdparty/Eigen/src/SparseCore/SparseFuzzy.h", "C++", 15, 0, 0, 0, 0, 8, 7, 30
"/home/sunny/workspace_private/3rd-test-learning/8. ceres/ceres_pnp/Thirdparty/Eigen/src/SparseCore/SparseMap.h", "C++", 194, 0, 0, 0, 0, 67, 45, 306
"/home/sunny/workspace_private/3rd-test-learning/8. ceres/ceres_pnp/Thirdparty/Eigen/src/SparseCore/SparseMatrix.h", "C++", 936, 0, 0, 0, 0, 311, 157, 1404
"/home/sunny/workspace_private/3rd-test-learning/8. ceres/ceres_pnp/Thirdparty/Eigen/src/SparseCore/SparseMatrixBase.h", "C++", 248, 0, 0, 0, 0, 80, 78, 406
"/home/sunny/workspace_private/3rd-test-learning/8. ceres/ceres_pnp/Thirdparty/Eigen/src/SparseCore/SparsePermutation.h", "C++", 128, 0, 0, 0, 0, 20, 31, 179
"/home/sunny/workspace_private/3rd-test-learning/8. ceres/ceres_pnp/Thirdparty/Eigen/src/SparseCore/SparseProduct.h", "C++", 117, 0, 0, 0, 0, 29, 24, 170
"/home/sunny/workspace_private/3rd-test-learning/8. ceres/ceres_pnp/Thirdparty/Eigen/src/SparseCore/SparseRedux.h", "C++", 34, 0, 0, 0, 0, 8, 8, 50
"/home/sunny/workspace_private/3rd-test-learning/8. ceres/ceres_pnp/Thirdparty/Eigen/src/SparseCore/SparseRef.h", "C++", 300, 0, 0, 0, 0, 35, 63, 398
"/home/sunny/workspace_private/3rd-test-learning/8. ceres/ceres_pnp/Thirdparty/Eigen/src/SparseCore/SparseSelfAdjointView.h", "C++", 480, 0, 0, 0, 0, 76, 100, 656
"/home/sunny/workspace_private/3rd-test-learning/8. ceres/ceres_pnp/Thirdparty/Eigen/src/SparseCore/SparseSolverBase.h", "C++", 75, 0, 0, 0, 0, 32, 18, 125
"/home/sunny/workspace_private/3rd-test-learning/8. ceres/ceres_pnp/Thirdparty/Eigen/src/SparseCore/SparseSparseProductWithPruning.h", "C++", 141, 0, 0, 0, 0, 31, 27, 199
"/home/sunny/workspace_private/3rd-test-learning/8. ceres/ceres_pnp/Thirdparty/Eigen/src/SparseCore/SparseTranspose.h", "C++", 65, 0, 0, 0, 0, 8, 20, 93
"/home/sunny/workspace_private/3rd-test-learning/8. ceres/ceres_pnp/Thirdparty/Eigen/src/SparseCore/SparseTriangularView.h", "C++", 134, 0, 0, 0, 0, 23, 33, 190
"/home/sunny/workspace_private/3rd-test-learning/8. ceres/ceres_pnp/Thirdparty/Eigen/src/SparseCore/SparseUtil.h", "C++", 122, 0, 0, 0, 0, 20, 37, 179
"/home/sunny/workspace_private/3rd-test-learning/8. ceres/ceres_pnp/Thirdparty/Eigen/src/SparseCore/SparseVector.h", "C++", 332, 0, 0, 0, 0, 68, 79, 479
"/home/sunny/workspace_private/3rd-test-learning/8. ceres/ceres_pnp/Thirdparty/Eigen/src/SparseCore/SparseView.h", "C++", 156, 0, 0, 0, 0, 56, 42, 254
"/home/sunny/workspace_private/3rd-test-learning/8. ceres/ceres_pnp/Thirdparty/Eigen/src/SparseCore/TriangularSolver.h", "C++", 254, 0, 0, 0, 0, 28, 34, 316
"/home/sunny/workspace_private/3rd-test-learning/8. ceres/ceres_pnp/Thirdparty/Eigen/src/SparseLU/SparseLU.h", "C++", 465, 0, 0, 0, 0, 223, 88, 776
"/home/sunny/workspace_private/3rd-test-learning/8. ceres/ceres_pnp/Thirdparty/Eigen/src/SparseLU/SparseLUImpl.h", "C++", 47, 0, 0, 0, 0, 12, 8, 67
"/home/sunny/workspace_private/3rd-test-learning/8. ceres/ceres_pnp/Thirdparty/Eigen/src/SparseLU/SparseLU_Memory.h", "C++", 132, 0, 0, 0, 0, 68, 27, 227
"/home/sunny/workspace_private/3rd-test-learning/8. ceres/ceres_pnp/Thirdparty/Eigen/src/SparseLU/SparseLU_Structs.h", "C++", 34, 0, 0, 0, 0, 69, 8, 111
"/home/sunny/workspace_private/3rd-test-learning/8. ceres/ceres_pnp/Thirdparty/Eigen/src/SparseLU/SparseLU_SupernodalMatrix.h", "C++", 188, 0, 0, 0, 0, 74, 40, 302
"/home/sunny/workspace_private/3rd-test-learning/8. ceres/ceres_pnp/Thirdparty/Eigen/src/SparseLU/SparseLU_Utils.h", "C++", 49, 0, 0, 0, 0, 20, 12, 81
"/home/sunny/workspace_private/3rd-test-learning/8. ceres/ceres_pnp/Thirdparty/Eigen/src/SparseLU/SparseLU_column_bmod.h", "C++", 89, 0, 0, 0, 0, 70, 23, 182
"/home/sunny/workspace_private/3rd-test-learning/8. ceres/ceres_pnp/Thirdparty/Eigen/src/SparseLU/SparseLU_column_dfs.h", "C++", 88, 0, 0, 0, 0, 67, 25, 180
"/home/sunny/workspace_private/3rd-test-learning/8. ceres/ceres_pnp/Thirdparty/Eigen/src/SparseLU/SparseLU_copy_to_ucol.h", "C++", 53, 0, 0, 0, 0, 43, 12, 108
"/home/sunny/workspace_private/3rd-test-learning/8. ceres/ceres_pnp/Thirdparty/Eigen/src/SparseLU/SparseLU_gemm_kernel.h", "C++", 216, 0, 0, 0, 0, 29, 36, 281
"/home/sunny/workspace_private/3rd-test-learning/8. ceres/ceres_pnp/Thirdparty/Eigen/src/SparseLU/SparseLU_heap_relax_snode.h", "C++", 72, 0, 0, 0, 0, 44, 11, 127
"/home/sunny/workspace_private/3rd-test-learning/8. ceres/ceres_pnp/Thirdparty/Eigen/src/SparseLU/SparseLU_kernel_bmod.h", "C++", 86, 0, 0, 0, 0, 30, 15, 131
"/home/sunny/workspace_private/3rd-test-learning/8. ceres/ceres_pnp/Thirdparty/Eigen/src/SparseLU/SparseLU_panel_bmod.h", "C++", 132, 0, 0, 0, 0, 62, 30, 224
"/home/sunny/workspace_private/3rd-test-learning/8. ceres/ceres_pnp/Thirdparty/Eigen/src/SparseLU/SparseLU_panel_dfs.h", "C++", 137, 0, 0, 0, 0, 86, 36, 259
"/home/sunny/workspace_private/3rd-test-learning/8. ceres/ceres_pnp/Thirdparty/Eigen/src/SparseLU/SparseLU_pivotL.h", "C++", 63, 0, 0, 0, 0, 62, 13, 138
"/home/sunny/workspace_private/3rd-test-learning/8. ceres/ceres_pnp/Thirdparty/Eigen/src/SparseLU/SparseLU_pruneL.h", "C++", 66, 0, 0, 0, 0, 58, 13, 137
"/home/sunny/workspace_private/3rd-test-learning/8. ceres/ceres_pnp/Thirdparty/Eigen/src/SparseLU/SparseLU_relax_snode.h", "C++", 34, 0, 0, 0, 0, 40, 10, 84
"/home/sunny/workspace_private/3rd-test-learning/8. ceres/ceres_pnp/Thirdparty/Eigen/src/SparseQR/SparseQR.h", "C++", 477, 0, 0, 0, 0, 180, 83, 740
"/home/sunny/workspace_private/3rd-test-learning/8. ceres/ceres_pnp/Thirdparty/Eigen/src/StlSupport/StdDeque.h", "C++", 96, 0, 0, 0, 0, 19, 12, 127
"/home/sunny/workspace_private/3rd-test-learning/8. ceres/ceres_pnp/Thirdparty/Eigen/src/StlSupport/StdList.h", "C++", 79, 0, 0, 0, 0, 15, 13, 107
"/home/sunny/workspace_private/3rd-test-learning/8. ceres/ceres_pnp/Thirdparty/Eigen/src/StlSupport/StdVector.h", "C++", 99, 0, 0, 0, 0, 21, 12, 132
"/home/sunny/workspace_private/3rd-test-learning/8. ceres/ceres_pnp/Thirdparty/Eigen/src/StlSupport/details.h", "C++", 57, 0, 0, 0, 0, 13, 15, 85
"/home/sunny/workspace_private/3rd-test-learning/8. ceres/ceres_pnp/Thirdparty/Eigen/src/SuperLUSupport/SuperLUSupport.h", "C++", 752, 0, 0, 0, 0, 117, 159, 1028
"/home/sunny/workspace_private/3rd-test-learning/8. ceres/ceres_pnp/Thirdparty/Eigen/src/UmfPackSupport/UmfPackSupport.h", "C++", 339, 0, 0, 0, 0, 80, 88, 507
"/home/sunny/workspace_private/3rd-test-learning/8. ceres/ceres_pnp/Thirdparty/Eigen/src/misc/Image.h", "C++", 57, 0, 0, 0, 0, 12, 14, 83
"/home/sunny/workspace_private/3rd-test-learning/8. ceres/ceres_pnp/Thirdparty/Eigen/src/misc/Kernel.h", "C++", 52, 0, 0, 0, 0, 14, 14, 80
"/home/sunny/workspace_private/3rd-test-learning/8. ceres/ceres_pnp/Thirdparty/Eigen/src/misc/RealSvd2x2.h", "C++", 36, 0, 0, 0, 0, 11, 9, 56
"/home/sunny/workspace_private/3rd-test-learning/8. ceres/ceres_pnp/Thirdparty/Eigen/src/misc/blas.h", "C++", 370, 0, 0, 0, 0, 2, 69, 441
"/home/sunny/workspace_private/3rd-test-learning/8. ceres/ceres_pnp/Thirdparty/Eigen/src/misc/lapack.h", "C++", 128, 0, 0, 0, 0, 0, 25, 153
"/home/sunny/workspace_private/3rd-test-learning/8. ceres/ceres_pnp/Thirdparty/Eigen/src/misc/lapacke.h", "C++", 15567, 0, 0, 0, 0, 64, 661, 16292
"/home/sunny/workspace_private/3rd-test-learning/8. ceres/ceres_pnp/Thirdparty/Eigen/src/misc/lapacke_mangling.h", "C++", 14, 0, 0, 0, 0, 0, 4, 18
"/home/sunny/workspace_private/3rd-test-learning/8. ceres/ceres_pnp/Thirdparty/Eigen/src/plugins/ArrayCwiseBinaryOps.h", "C++", 134, 0, 0, 0, 0, 170, 29, 333
"/home/sunny/workspace_private/3rd-test-learning/8. ceres/ceres_pnp/Thirdparty/Eigen/src/plugins/ArrayCwiseUnaryOps.h", "C++", 240, 0, 0, 0, 0, 285, 43, 568
"/home/sunny/workspace_private/3rd-test-learning/8. ceres/ceres_pnp/Thirdparty/Eigen/src/plugins/BlockMethods.h", "C++", 443, 0, 0, 0, 0, 517, 99, 1059
"/home/sunny/workspace_private/3rd-test-learning/8. ceres/ceres_pnp/Thirdparty/Eigen/src/plugins/CommonCwiseBinaryOps.h", "C++", 41, 0, 0, 0, 0, 63, 12, 116
"/home/sunny/workspace_private/3rd-test-learning/8. ceres/ceres_pnp/Thirdparty/Eigen/src/plugins/CommonCwiseUnaryOps.h", "C++", 69, 0, 0, 0, 0, 78, 17, 164
"/home/sunny/workspace_private/3rd-test-learning/8. ceres/ceres_pnp/Thirdparty/Eigen/src/plugins/MatrixCwiseBinaryOps.h", "C++", 61, 0, 0, 0, 0, 79, 13, 153
"/home/sunny/workspace_private/3rd-test-learning/8. ceres/ceres_pnp/Thirdparty/Eigen/src/plugins/MatrixCwiseUnaryOps.h", "C++", 25, 0, 0, 0, 0, 49, 12, 86
"/home/sunny/workspace_private/3rd-test-learning/8. ceres/ceres_pnp/Thirdparty/sophus/ensure.hpp", "C++", 131, 0, 0, 0, 0, 30, 27, 188
"/home/sunny/workspace_private/3rd-test-learning/8. ceres/ceres_pnp/Thirdparty/sophus/rxso3.hpp", "C++", 337, 0, 0, 0, 0, 377, 77, 791
"/home/sunny/workspace_private/3rd-test-learning/8. ceres/ceres_pnp/Thirdparty/sophus/se2.hpp", "C++", 354, 0, 0, 0, 0, 365, 83, 802
"/home/sunny/workspace_private/3rd-test-learning/8. ceres/ceres_pnp/Thirdparty/sophus/se3.hpp", "C++", 401, 0, 0, 0, 0, 425, 97, 923
"/home/sunny/workspace_private/3rd-test-learning/8. ceres/ceres_pnp/Thirdparty/sophus/sim3.hpp", "C++", 441, 0, 0, 0, 0, 390, 87, 918
"/home/sunny/workspace_private/3rd-test-learning/8. ceres/ceres_pnp/Thirdparty/sophus/so2.hpp", "C++", 243, 0, 0, 0, 0, 313, 72, 628
"/home/sunny/workspace_private/3rd-test-learning/8. ceres/ceres_pnp/Thirdparty/sophus/so3.hpp", "C++", 325, 0, 0, 0, 0, 397, 83, 805
"/home/sunny/workspace_private/3rd-test-learning/8. ceres/ceres_pnp/Thirdparty/sophus/sophus.hpp", "C++", 17, 0, 0, 0, 0, 21, 10, 48
"/home/sunny/workspace_private/3rd-test-learning/8. ceres/ceres_pnp/Thirdparty/sophus/test_macros.hpp", "C++", 98, 0, 0, 0, 0, 6, 16, 120
"/home/sunny/workspace_private/3rd-test-learning/8. ceres/ceres_pnp/cmake/FindBLAS.cmake", "CMake", 0, 0, 0, 381, 0, 0, 39, 420
"/home/sunny/workspace_private/3rd-test-learning/8. ceres/ceres_pnp/cmake/FindCSparse.cmake", "CMake", 0, 0, 0, 23, 0, 0, 3, 26
"/home/sunny/workspace_private/3rd-test-learning/8. ceres/ceres_pnp/cmake/FindCXSparse.cmake", "CMake", 0, 0, 0, 189, 0, 0, 16, 205
"/home/sunny/workspace_private/3rd-test-learning/8. ceres/ceres_pnp/cmake/FindCeres.cmake", "CMake", 0, 0, 0, 53, 0, 0, 8, 61
"/home/sunny/workspace_private/3rd-test-learning/8. ceres/ceres_pnp/cmake/FindCholmod.cmake", "CMake", 0, 0, 0, 67, 0, 0, 23, 90
"/home/sunny/workspace_private/3rd-test-learning/8. ceres/ceres_pnp/cmake/FindFREEGLUT.cmake", "CMake", 0, 0, 0, 38, 0, 0, 8, 46
"/home/sunny/workspace_private/3rd-test-learning/8. ceres/ceres_pnp/cmake/FindG2O.cmake", "CMake", 0, 0, 0, 98, 0, 0, 16, 114
"/home/sunny/workspace_private/3rd-test-learning/8. ceres/ceres_pnp/cmake/FindGLEW.cmake", "CMake", 0, 0, 0, 50, 0, 0, 4, 54
"/home/sunny/workspace_private/3rd-test-learning/8. ceres/ceres_pnp/cmake/FindGlog.cmake", "CMake", 0, 0, 0, 192, 0, 0, 18, 210
"/home/sunny/workspace_private/3rd-test-learning/8. ceres/ceres_pnp/cmake/FindLAPACK.cmake", "CMake", 0, 0, 0, 245, 0, 0, 29, 274
"/home/sunny/workspace_private/3rd-test-learning/8. ceres/ceres_pnp/cmake/FindQGLViewer.cmake", "CMake", 0, 0, 0, 50, 0, 0, 5, 55
"/home/sunny/workspace_private/3rd-test-learning/8. ceres/ceres_pnp/cmake/FindSuiteSparse.cmake", "CMake", 0, 0, 0, 110, 0, 0, 18, 128
"/home/sunny/workspace_private/3rd-test-learning/8. ceres/ceres_pnp/main.cpp", "C++", 15, 0, 0, 0, 0, 4, 7, 26
"/home/sunny/workspace_private/3rd-test-learning/8. ceres/data.hpp", "C++", 70, 0, 0, 0, 0, 8, 2, 80
"/home/sunny/workspace_private/3rd-test-learning/9. ros-melodic/src/ros-melodic-test/include/ros-melodic-test/test-use-function.hpp", "C++", 26, 0, 0, 0, 0, 9, 3, 38
"/home/sunny/workspace_private/3rd-test-learning/9. ros-melodic/src/ros-melodic-test/package.xml", "XML", 0, 0, 32, 0, 0, 36, 13, 81
"/home/sunny/workspace_private/3rd-test-learning/9. ros-melodic/src/ros-melodic-test/src/9.1 set-polygen-in-rviz.cpp", "C++", 45, 0, 0, 0, 0, 9, 8, 62
"/home/sunny/workspace_private/3rd-test-learning/9. ros-melodic/src/ros-melodic-test/src/9.2 set-logging-level.cpp", "C++", 13, 0, 0, 0, 0, 8, 6, 27
"/home/sunny/workspace_private/3rd-test-learning/9. ros-melodic/src/ros-melodic-test/src/9.3 visualizetion_msgs-test.cpp", "C++", 234, 0, 0, 0, 0, 11, 49, 294
"/home/sunny/workspace_private/3rd-test-learning/9. ros-melodic/src/ros-melodic-test/src/9.4 multiple-nodehandle-test.cpp", "C++", 0, 0, 0, 0, 0, 0, 1, 1
"/home/sunny/workspace_private/3rd-test-learning/9. ros-melodic/src/ros-melodic-test/src/9.5.1 multiple-spinner-test.cpp", "C++", 15, 0, 0, 0, 0, 12, 8, 35
"/home/sunny/workspace_private/3rd-test-learning/9. ros-melodic/src/ros-melodic-test/src/9.5.2 spinner-with-callbackqueue.cpp", "C++", 29, 0, 0, 0, 0, 18, 15, 62
"/home/sunny/workspace_private/3rd-test-learning/9. ros-melodic/src/ros-melodic-test/src/viz-template.cpp", "C++", 659, 0, 0, 0, 0, 10, 89, 758
"Total", "-", 84693, 3, 32, 1496, 13, 24571, 15372, 126180