"filename", "language", "C++", "Markdown", "YAML", "comment", "blank", "total"
"/home/sunny/workspace_private/3rd-test-learning/19. sensor_funsion_hw/hw1_ceres_ndt/ceres_ndt.cpp", "C++", 43, 0, 0, 29, 25, 97
"/home/sunny/workspace_private/3rd-test-learning/19. sensor_funsion_hw/hw1_ceres_ndt/ceres_ndt_se3.h", "C++", 161, 0, 0, 19, 47, 227
"/home/sunny/workspace_private/3rd-test-learning/19. sensor_funsion_hw/hw1_ceres_ndt/filter.hpp", "C++", 20, 0, 0, 11, 5, 36
"/home/sunny/workspace_private/3rd-test-learning/19. sensor_funsion_hw/hw1_ceres_ndt/icp_registration.hpp", "C++", 154, 0, 0, 27, 46, 227
"/home/sunny/workspace_private/3rd-test-learning/19. sensor_funsion_hw/hw2_SC/Scancontext.cpp", "C++", 276, 0, 0, 45, 97, 418
"/home/sunny/workspace_private/3rd-test-learning/19. sensor_funsion_hw/hw2_SC/Scancontext.h", "C++", 71, 0, 0, 11, 30, 112
"/home/sunny/workspace_private/3rd-test-learning/19. sensor_funsion_hw/hw2_SC/robot_relocalization_node.cpp", "C++", 181, 0, 0, 10, 43, 234
"/home/sunny/workspace_private/3rd-test-learning/19. sensor_funsion_hw/hw2_SC/sc_loop.cpp", "C++", 176, 0, 0, 45, 67, 288
"/home/sunny/workspace_private/3rd-test-learning/19. sensor_funsion_hw/hw2_SC/sc_loop.h", "C++", 54, 0, 0, 7, 13, 74
"/home/sunny/workspace_private/3rd-test-learning/19. sensor_funsion_hw/hw3_calibra/SO3_RK4_test.cpp", "C++", 113, 0, 0, 50, 22, 185
"/home/sunny/workspace_private/3rd-test-learning/19. sensor_funsion_hw/hw3_calibra/hw_3_2_accel.cpp", "C++", 110, 0, 0, 15, 23, 148
"/home/sunny/workspace_private/3rd-test-learning/19. sensor_funsion_hw/hw3_calibra/hw_3_2_gyro.cpp", "C++", 146, 0, 0, 18, 29, 193
"/home/sunny/workspace_private/3rd-test-learning/19. sensor_funsion_hw/hw3_calibra/hw_3_3.cpp", "C++", 426, 0, 0, 101, 91, 618
"/home/sunny/workspace_private/3rd-test-learning/19. sensor_funsion_hw/hw3_calibra/hw_3_4.cpp", "C++", 174, 0, 0, 13, 24, 211
"/home/sunny/workspace_private/3rd-test-learning/19. sensor_funsion_hw/hw3_calibra/read_csv.h", "C++", 66, 0, 0, 29, 14, 109
"/home/sunny/workspace_private/3rd-test-learning/19. sensor_funsion_hw/hw4_filter/ImuTypes.cc", "C++", 125, 0, 0, 18, 16, 159
"/home/sunny/workspace_private/3rd-test-learning/19. sensor_funsion_hw/hw4_filter/ImuTypes.h", "C++", 22, 0, 0, 1, 10, 33
"/home/sunny/workspace_private/3rd-test-learning/19. sensor_funsion_hw/hw4_filter/backup/ImuTypes.cc", "C++", 419, 0, 0, 31, 70, 520
"/home/sunny/workspace_private/3rd-test-learning/19. sensor_funsion_hw/hw4_filter/backup/ImuTypes.h", "C++", 22, 0, 0, 1, 6, 29
"/home/sunny/workspace_private/3rd-test-learning/19. sensor_funsion_hw/hw4_filter/backup/common.cpp", "C++", 85, 0, 0, 11, 12, 108
"/home/sunny/workspace_private/3rd-test-learning/19. sensor_funsion_hw/hw4_filter/backup/common.h", "C++", 43, 0, 0, 8, 14, 65
"/home/sunny/workspace_private/3rd-test-learning/19. sensor_funsion_hw/hw4_filter/backup/ekf.cpp", "C++", 145, 0, 0, 8, 50, 203
"/home/sunny/workspace_private/3rd-test-learning/19. sensor_funsion_hw/hw4_filter/backup/ekf.h", "C++", 244, 0, 0, 48, 58, 350
"/home/sunny/workspace_private/3rd-test-learning/19. sensor_funsion_hw/hw4_filter/backup/ekf_test.cpp", "C++", 184, 0, 0, 18, 35, 237
"/home/sunny/workspace_private/3rd-test-learning/19. sensor_funsion_hw/hw4_filter/backup/read_csv.h", "C++", 66, 0, 0, 29, 14, 109
"/home/sunny/workspace_private/3rd-test-learning/19. sensor_funsion_hw/hw4_filter/backup_pre/svd_test.cpp", "C++", 7, 0, 0, 8, 2, 17
"/home/sunny/workspace_private/3rd-test-learning/19. sensor_funsion_hw/hw4_filter/common.cpp", "C++", 68, 0, 0, 11, 9, 88
"/home/sunny/workspace_private/3rd-test-learning/19. sensor_funsion_hw/hw4_filter/common.h", "C++", 41, 0, 0, 8, 13, 62
"/home/sunny/workspace_private/3rd-test-learning/19. sensor_funsion_hw/hw4_filter/config/eskf.yaml", "YAML", 0, 0, 10, 0, 2, 12
"/home/sunny/workspace_private/3rd-test-learning/19. sensor_funsion_hw/hw4_filter/data_collector.cpp", "C++", 1, 0, 0, 7, 2, 10
"/home/sunny/workspace_private/3rd-test-learning/19. sensor_funsion_hw/hw4_filter/data_collector.h", "C++", 106, 0, 0, 11, 15, 132
"/home/sunny/workspace_private/3rd-test-learning/19. sensor_funsion_hw/hw4_filter/ekf_test.cpp", "C++", 211, 0, 0, 33, 43, 287
"/home/sunny/workspace_private/3rd-test-learning/19. sensor_funsion_hw/hw4_filter/error_state_kalman_filter.cpp", "C++", 93, 0, 0, 29, 26, 148
"/home/sunny/workspace_private/3rd-test-learning/19. sensor_funsion_hw/hw4_filter/error_state_kalman_filter.h", "C++", 34, 0, 0, 12, 10, 56
"/home/sunny/workspace_private/3rd-test-learning/19. sensor_funsion_hw/hw4_filter/kalman_filter.cpp", "C++", 141, 0, 0, 71, 40, 252
"/home/sunny/workspace_private/3rd-test-learning/19. sensor_funsion_hw/hw4_filter/kalman_filter.h", "C++", 43, 0, 0, 11, 14, 68
"/home/sunny/workspace_private/3rd-test-learning/19. sensor_funsion_hw/hw4_filter/kalman_filter_interface.h", "C++", 24, 0, 0, 10, 4, 38
"/home/sunny/workspace_private/3rd-test-learning/19. sensor_funsion_hw/hw4_filter/measure_module.h", "C++", 92, 0, 0, 7, 11, 110
"/home/sunny/workspace_private/3rd-test-learning/19. sensor_funsion_hw/hw4_filter/read_csv.h", "C++", 77, 0, 0, 29, 13, 119
"/home/sunny/workspace_private/3rd-test-learning/19. sensor_funsion_hw/hw4_filter/推导过程.md", "Markdown", 0, 23, 0, 0, 7, 30
"Total", "-", 4464, 23, 10, 850, 1072, 6419